var level1 = [
	"name":"Level 01",
	"author":"Raul",
	"date":"12/07/2015",
	"tileset":"3",
	"background":"1",
	"platformLayer":
	"11111111111100000000111111111111|"+
	"99000000000000000000000000000099|"+
	"99000000000001111110000000000099|"+
	"99000000000000000000000000000099|"+
	"99000000000000000000000000000099|"+
	"99000011111111111111111111000099|"+
	"99000000000000000000000000000099|"+
	"99000000000000000000000000000099|"+
	"99001111111110000001111111110099|"+
	"99000000000000000000000000000099|"+
	"99000000000000000000000000000099|"+
	"99000000000011111111000000000099|"+
	"99000000000000000000000000000099|"+
	"99000000000000000000000000000099|"+
	"99001111111111000011111111110099|"+
	"99000000000000000000000000000099|"+
	"99000000000000000000000000000099|"+
	"99001111111111111111111111110099|"+
	"99000000000000000000000000000099|"+
	"99000000000000000000000000000099|"+
	"11111111111100000000111111111111",
	"pathLayer":
	"11111111111100000000111111111111|"+
	"99000000000000000000000000000099|"+
	"99000000000001111110000000000099|"+
	"99000000000000000000000000000099|"+
	"99000000000000U00U00000000000099|"+
	"99000011111111111111111111000099|"+
	"99000000000000000000000000000099|"+
	"9900000000U0R000000L0U0000000099|"+
	"99001111111110000001111111110099|"+
	"99000000000000000000000000000099|"+
	"990000000000U000000U000000000099|"+
	"99000000000011111111000000000099|"+
	"99000000000000000000000000000099|"+
	"990000000000UR0000LU000000000099|"+
	"99001111111111000011111111110099|"+
	"99000000000000000000000000000099|"+
	"9900000U0000000000000000U0000099|"+
	"99001111111111111111111111110099|"+
	"99000000000000000000000000000099|"+
	"9900000U0000000000000000U0000099|"+
	"11111111111100000000111111111111",
	"enemyLayer":
	"11111111111100000000111111111111|"+
	"99000000000000000000000000000099|"+
	"99000000000001111110000000000099|"+
	"99000000000000000000000000000099|"+
	"9900000000A0000000000A0000000099|"+
	"99000011111111111111111111000099|"+
	"99000000000000000000000000000099|"+
	"990000000A00000000000000A0000099|"+
	"99001111111110000001111111110099|"+
	"99000000000000000000000000000099|"+
	"99000000000000000000000000000099|"+
	"99000000000011111111000000000099|"+
	"99000000000000000000000000000099|"+
	"99000000A00000000000000A00000099|"+
	"99001111111111000011111111110099|"+
	"99000000000000000000000000000099|"+
	"99000000000000000000000000000099|"+
	"99001111111111111111111111110099|"+
	"99000000000000000000000000000099|"+
	"99000000000000000000000000000099|"+
	"11111111111100000000111111111111"
]